111111111111111111
1000C0001000001111
11110001E000000001
100000C00001000001
10000F00001C100001
10000000F000011101
100C00000000000001
10011100000000C001
1000F0000000000001
111100000000C00001
1000000000000F0001
10000F000011110001
100000000000000001
111100000C00000001
100000000000000001
10000C001100000001
10000F00000C000001
100000000000000001
101111000000000001
10000000P000000001
111111111111111111