1111111111111111111111111111111111111111
1000000000000000000000000000000000000001
100000000000000000000000000C000000000011
100000000E000000000000000000000000000111
1000000000000000000000000000111110000011
1000000000000000000000000000000000000001
1000000001110000000000000000000000000001
1000000000000100000000000000000000000001
1000000000001C00000000000000000000000011
1000000000000110000000000000000C00000001
1000000000000000000000000000000000000001
1000000000000000000P00000000000000000001
1000000000000000000000000000000000000001
1000000001110000000000000000000000000001
1000000000000000000000000000000000000001
1111111111111111111111111111111111111111